You wake up, having no idea where you are or how you got here. 

Mostly, this occurred because the author was too uncreative to write out a proper backstory for you.  A medical diagnosis of amnesia occurs only in perhaps four out of 100,000 patients, and people with actual amnesia practically never forget who they are, but it is convenient to stick with the popular fiction here, because figuring out a backstory for the player character would take a lot of thinking, and thinking is hard, and writing interactive fiction is even harder than thinking.

Unwinnable By Design
An Interactive (insert game genre name here) Fiction by John Byrd
Release 1 / Serial number 240811 / Inform 7 v10.1.2 / D

Starting Room
This is the room that the game starts you in. Note to self: come back and write a detailed description of this room. It needs to have lots of interesting things to look at, to create the tone and setting for the game. Gamers care a lot about such things, like tone and setting, so I need to make it interesting.

You can see an NPC and an object here.

What?

Hello?

Huh?

I beg your pardon?

Um?

Look, I'm running out of random responses here.

Seriously, this is the last one.

Now, I'm totally going to loop back and use previous responses now.

Stop trying to make me say something new.

I'm really out of things to say at this point.

Come on, give it a rest.

Holy crap, you are persistent.

This becomes tiresome.

I grow weary of this motif.

Okay, what the hell is it you want here?

You're putting me in a special sort of hell, you know.

This is a video game. This is supposed to be fun. You're not supposed to be just reading through the random responses and enjoying them.

God, you are annoying.

CUT IT OUT!

STOP!

Okay, fine. Your Easter egg code is "xyzzy".

STOP!

* * *

Okay, fine. Your Easter egg code is "xyzzy".

CUT IT OUT!

>xyzzy
You entered a cheat code, unlocking an Easter egg of bonus content in this game! Note to self: puff up the player's ego at this point, and make sure to give them lots of points and enable god mode as a reward.

Also, additional note to self: be sure to write said bonus content later.

Also, additional additional note to self: figure out what god mode means.

You are carrying:
  an Easter egg

* * *

Hello?

>rules
Rules tracing now switched on. Type "rules off" to switch it off again, or "rules all" to include even rules which do not apply.

[Rule "parse command rule" applies.]

I beg your pardon?

>track responses
[Rule "Response Assistant reset responses list rule" applies.]
[Rule "declare everything initially unmentioned rule" applies.]
[Rule "generate action rule" applies.]
[Rule "work out details of specific action rule" applies.]
[Rule "investigate player's awareness before action rule" applies.]
[Rule "player aware of his own actions rule" applies.]
[Rule "check stage rule" applies.]
[Rule "carry out stage rule" applies.]
[Rule "Carry out response tracking" applies.]
Now tracking responses. Type "track off" to disable.
[Rule "after stage rule" applies.]
[Rule "investigate player's awareness after action rule" applies.]
[Rule "report stage rule" applies.]
[Rule "last specific action-processing rule" applies.]

[Rule "parse command rule" applies.]

[I beg your pardon? - type "response 1" for details]

>response 1
[Rule "declare everything initially unmentioned rule" applies.]
[Rule "generate action rule" applies.]
[Rule "work out details of specific action rule" applies.]
[Rule "investigate player's awareness before action rule" applies.]
[Rule "player aware of his own actions rule" applies.]
[Rule "check stage rule" applies.]
[Rule "carry out stage rule" applies.]
[Rule "Carry out requesting response info" applies.]
parser error internal rule response (X)

Currently:
"I beg your pardon?"

To change, copy and pase the following line into your source:
The parser error internal rule response (X) is "New response text."

* Note: if this response was defined in your own source text, of course, it's easier to change it by searching for the text in your project and updating the original.
[Rule "after stage rule" applies.]
[Rule "investigate player's awareness after action rule" applies.]
[Rule "report stage rule" applies.]
[Rule "last specific action-processing rule" applies.]

[Rule "parse command rule" applies.]

* * *

What?

>attack m
You can't see any such thing.

>attack me
You attack yourself.

>attack npc
You attack the NPC.

Wonderful, you kill the NPC. The NPC is now completely dead. I guess you're expecting some sort of in-game reward, like some sort of clever death dialogue, or maybe your score will go up. Look at you, going through this video game, committing a random act of violence upon a helpless NPC. Look at what your video game addiction has done to you. It's made you into a violent random killer. Whatever. The NPC is now completely dead, and it's all your fault.
And that NPC also is carrying a quest, which you can't actually accomplish anymore, because the NPC is dead, so you might as well reload the game at this point. Or not, see if I care.

[Your score has just gone down by one point.]

>restart
Are you sure you want to restart?

>y
You wake up, having no idea where you are or how you got here. 

Mostly, this occurred because the author was too uncreative to write out a proper backstory for you.  A medical diagnosis of amnesia occurs only in perhaps four out of 100,000 patients, and people with actual amnesia practically never forget who they are, but it is convenient to stick with the popular fiction here, because figuring out a backstory for the player character would take a lot of thinking, and thinking is hard, and writing interactive fiction is even harder than thinking.

Unwinnable By Design
An Interactive (insert game genre name here) Fiction by John Byrd
Release 1 / Serial number 240811 / Inform 7 v10.1.2 / D

Starting Room
This is the room that the game starts you in. Note to self: come back and write a detailed description of this room. It needs to have lots of interesting things to look at, to create the tone and setting for the game. Gamers care a lot about such things, like tone and setting, so I need to make it interesting.

You can see an NPC and an object here.

>npc, attack me
Violence is apparently the answer to this one.

What?

>showme attack
There seems to be no such object anywhere in the model world.

>showme the meaning of the verb attack
There seems to be no such object anywhere in the model world.

Hello?

>showme
Starting Room - room
    yourself - person
    NPC - person
        red key
        quest
    object

Huh?

>actions
Actions listing on.

>attack me
[attacking yourself]
You attack yourself.

[attacking yourself - succeeded]

>npc, attack me
[asking the NPC to try attacking yourself]
[(1) the NPC attacking yourself]
Violence is apparently the answer to this one.
[(1) the NPC attacking yourself - succeeded]

[asking the NPC to try attacking yourself - succeeded]

* * *

What?

>look at npc
You see nothing special about the NPC. The NPC is a non-player character. "Non-player character" is a professional term of art used amongst professional game designers, so I don't expect you to understand what it means. It's a very technical term, meaning that you don't control that character, as opposed to the player character, which you do control. I don't want to get into it all right now. Just assume that the NPC is a person, with lots of interesting dialogue and interactions that make the game more colorful and realistic. The NPC is carrying a red key and a quest.

>x quet
You can't see any such thing.

>x quest
It's a game quest, which the NPC is supposed to give to you. It's probably to collect 10 herbs, or wolf pelts, or something like that, but I'm going to have to go in and write code for those things at some point.

* * *

What?

>talk to npc
You looks at you with a blank expression and says, "I once saw a purple elephant!, Did you know that clouds are actually made of cotton candy?, I think my left shoe is trying to communicate with me., Sometimes I dream I'm a talking banana. and I'm convinced that squirrels are secretly running the world."

>g
You looks at you with a blank expression and says, "What were we talking about again?
"

>g
You looks at you with a blank expression and says, "I once saw a purple elephant!, Did you know that clouds are actually made of cotton candy?, I think my left shoe is trying to communicate with me., Sometimes I dream I'm a talking banana. and I'm convinced that squirrels are secretly running the world."

>g
You looks at you with a blank expression and says, "What were we talking about again?
"

>g
You looks at you with a blank expression and says, "I once saw a purple elephant!, Did you know that clouds are actually made of cotton candy?, I think my left shoe is trying to communicate with me., Sometimes I dream I'm a talking banana. and I'm convinced that squirrels are secretly running the world."
The NPC suddenly exclaims, "
*** Run-time problem P10: Since nothing is not allowed the property "chatter", it is against the rules to try to use it.

"

Hello?

* * *

What?

>x npc
You see nothing special about the NPC. The NPC is a non-player character. "Non-player character" is a professional term of art used amongst professional game designers, so I don't expect you to understand what it means. It's a very technical term, meaning that you don't control that character, as opposed to the player character, which you do control. I don't want to get into it all right now. Just assume that the NPC is a person, with lots of interesting dialogue and interactions that make the game more colorful and realistic. The NPC is carrying a red key and a quest.

>kill npc
You attack the NPC, causing 5 damage.  Unfortunately, I'm not tracking the maximum amount of damage that the NPC can handle, so you can go on an inflict infinite damage to the NPC, and it doesn't make a bit of difference to the gameplay.

Wonderful, you kill the NPC. The NPC is now completely dead. I guess you're expecting some sort of in-game reward, like some sort of clever death dialogue, or maybe your score will go up. Look at you, going through this video game, committing a random act of violence upon a helpless NPC. Look at what your video game addiction has done to you. It's made you into a violent random killer. Whatever. The NPC is now completely dead, and it's all your fault.
Wonderful, you kill the NPC. The NPC is now completely dead. I guess you're expecting some sort of in-game reward, like some sort of clever death dialogue, or maybe your score will go up. Look at you, going through this video game, committing a random act of violence upon a helpless NPC. Look at what your video game addiction has done to you. It's made you into a violent random killer. Whatever. The NPC is now completely dead, and it's all your fault.
 And that NPC also is carrying a quest, which you can't actually accomplish anymore, because the NPC is dead, so you might as well reload the game at this point. Or not, see if I care.

[Your score has just gone down by one point.]

* * *

>actions
Actions listing on.

>rules
Rules tracing now switched on. Type "rules off" to switch it off again, or "rules all" to include even rules which do not apply.

[Rule "parse command rule" applies.]

>npc, attack me
[Rule "Response Assistant reset responses list rule" applies.]
[Rule "declare everything initially unmentioned rule" applies.]
[Rule "generate action rule" applies.]
[asking the NPC to try attacking yourself]
[Rule "announce items from multiple object lists rule" applies.]
[Rule "set pronouns from items from multiple object lists rule" applies.]
[Rule "before stage rule" applies.]
[Rule "basic visibility rule" applies.]
[Rule "basic accessibility rule" applies.]
[Rule "keychain-aware carrying requirements rule" applies.]
[Rule "instead stage rule" applies.]
[Rule "requested actions require persuasion rule" applies.]
[Rule "Persuasion rule for asking the NPC to try doing something" applies.]
[Rule "carry out requested actions rule" applies.]
[(1) the NPC attacking yourself]
[Rule "announce items from multiple object lists rule" applies.]
[Rule "set pronouns from items from multiple object lists rule" applies.]
[Rule "before stage rule" applies.]
[Rule "basic visibility rule" applies.]
[Rule "basic accessibility rule" applies.]
[Rule "access through barriers rule" applies.]
[Rule "keychain-aware carrying requirements rule" applies.]
[Rule "instead stage rule" applies.]
[Rule "requested actions require persuasion rule" applies.]
[Rule "carry out requested actions rule" applies.]
[Rule "descend to specific action-processing rule" applies.]
[Rule "work out details of specific action rule" applies.]
[Rule "investigate player's awareness before action rule" applies.]
[Rule "player aware of his own actions rule" applies.]
[Rule "player aware of actions by visible actors rule" applies.]
[Rule "check stage rule" applies.]
[Rule "carry out stage rule" applies.]
[Rule "after stage rule" applies.]
[Rule "investigate player's awareness after action rule" applies.]
[Rule "report stage rule" applies.]
[Rule "last specific action-processing rule" applies.]
[(1) the NPC attacking yourself - succeeded]

[asking the NPC to try attacking yourself - succeeded]

[Rule "A first turn sequence rule" applies.]
[Rule "scene change machinery rule" applies.]
[Rule "every turn stage rule" applies.]
[Rule "timed events rule" applies.]
[Rule "advance time rule" applies.]
[Rule "update chronological records rule" applies.]
[Rule "A last turn sequence rule" applies.]
[Rule "scene change machinery rule" applies.]
[Rule "adjust light rule" applies.]
[Rule "note object acquisitions rule" applies.]
[Rule "notify score changes rule" applies.]
[Rule "parse command rule" applies.]

* * *

>eat quest
Okay, by your request, you eat the abstract quest. Now I have no idea whether the game is actually solvable or not without the abstract quest, and I haven't tested it, but there's a very good chance that you've got the game into an unwinnable state, because I'm not going to go through and implement the mechanics of yourself defecating the abstract quest some hours later, because that would be disgusting. I'm going to simply remove the noun from play. Now if that makes the game unwinnable, that's just as it may be, I can't help you there.

[Your score has just gone down by one point.]

>restart
Are you sure you want to restart?

>y
You wake up, having no idea where you are or how you got here. 

Mostly, this occurred because the author was too uncreative to write out a proper backstory for you.  A medical diagnosis of amnesia occurs only in perhaps four out of 100,000 patients, and people with actual amnesia practically never forget who they are, but it is convenient to stick with the popular fiction here, because figuring out a backstory for the player character would take a lot of thinking, and thinking is hard, and writing interactive fiction is even harder than thinking.

Unwinnable By Design
An Interactive (insert game genre name here) Fiction by John Byrd
Release 1 / Serial number 240811 / Inform 7 v10.1.2 / D

Starting Room
This is the room that the game starts you in. Note to self: come back and write a detailed description of this room. It needs to have lots of interesting things to look at, to create the tone and setting for the game. Gamers care a lot about such things, like tone and setting, so make sure to make it good.

You can see an NPC and an object here.

>smell quest
You smell nothing unexpected.

>take quest
Technically, you're not supposed to be able to do that, because there's a default rule that prevents you from taking other people's possessions. I intended to make a puzzle here, where you had to say some sort of password like "xyzzy" to the NPC, but I never got around to implementing it, so there's this bug you can exploit, where you can just whatever the NPC is holding without asking permission first. I will get around to patching this bug in the next release of this game.

Taken.

>xyzzy
You entered a cheat code, unlocking an Easter egg of bonus content in this game! Note to self: puff up the player's ego at this point, and make sure to give them lots of points and enable god mode as a reward.

Also, additional note to self: be sure to write said bonus content later.

Also, additional additional note to self: figure out what god mode means.

You are carrying:
  an Easter egg
  an abstract quest

* * *

>attack npc
Wonderful, you kill the NPC. The NPC is now completely dead. I guess you're expecting some sort of in-game reward, like some sort of clever death dialogue, or maybe your score will go up. Look at you, going through this video game, committing a random act of violence upon a helpless NPC. Look at what your video game addiction has done to you. It's made you into a violent random killer. Whatever. The NPC is now completely dead, and it's all your fault.
And that NPC also is carrying a quest, which you can't actually accomplish anymore, because the NPC is dead, so you might as well reload the game at this point. Or not, see if I care.

[Your score has just gone down by one point.]

* * *

>kill npc
Wonderful, you kill the NPC. The NPC is now completely dead. I guess you're expecting some sort of in-game reward, like some sort of clever death dialogue, or maybe your score will go up. Look at you, going through this video game, committing a random act of violence upon a helpless NPC. Look at what your video game addiction has done to you. It's made you into a violent random killer. Whatever. The NPC is now completely dead, and it's all your fault.
And that NPC also is carrying a quest, which you can't actually accomplish anymore, because the NPC is dead, so you might as well reload the game at this point. Or not, see if I care.

[Your score has just gone down by one point.]

I beg your pardon?

I beg your pardon?

>kill npc
Are you completely and utterly deranged? You've already killed the NPC. The NPC is dead. That is the end of the NPC. It is a well deaded NPC.
And that NPC also is carrying a quest, which you can't actually accomplish anymore, because the NPC is dead, so you might as well reload the game at this point. Or not, see if I care.

I beg your pardon?

>take quest
The quest is abstract, which means that it doesn't exist as a physical object, which means that you can't interact with it. So I don't even understand why you are trying, really.

* * *

>npc, attack me
The NPC suddenly exclaims, "I forgot what I was going to say."

>attack me
You attack yourself.

>npc, attack me
Violence is apparently the answer to this one.

The NPC suddenly exclaims, "I forgot what I was going to say.
"

>z
Time passes.

>z
Time passes.

>z
Time passes.

The NPC suddenly exclaims, "
*** Run-time problem P10: Since nothing is not allowed the property "chatter", it is against the rules to try to use it.

"

* * *

>npc, attack me
The NPC suddenly exclaims, "I forgot what I was going to say."

>g
The NPC suddenly exclaims, "I forgot what I was going to say."

>g
The NPC suddenly exclaims, "I forgot what I was going to say."

* * *

>npc, go west
The NPC is unable to do that.

* * *

>put npc in object
(first taking the NPC)
I suppose the NPC wouldn't care for that. However, this is just a game, and technically it is possible to pick other people up, and default rules are still confusing to me, so whatever, I won't bother checking whether it is impossible or not.

That can't contain things.

>i
You are carrying:
  an NPC

>x npc
You see nothing special about the NPC. The NPC is a non-player character. "Non-player character" is a professional term of art used amongst professional game designers, so I don't expect you to understand what it means. It's a very technical term, meaning that you don't control that character, as opposed to the player character, which you do control. I don't want to get into it all right now. Just assume that the NPC is a person, with lots of interesting dialogue and interactions that make the game more colorful and realistic. The NPC is carrying a red key and a quest.

>take quest
The quest is abstract, which means that it doesn't exist as a physical object, which means that you can't interact with it. So I don't even understand why you are trying, really.

* * *

>take quest
That's abstract!

>x npc
You see nothing special about the NPC. The NPC is a non-player character. "Non-player character" is a professional term of art used amongst professional game designers, so I don't expect you to understand what it means. It's a very technical term, meaning that you don't control that character, as opposed to the player character, which you do control. I don't want to get into it all right now. Just assume that the NPC is a person, with lots of interesting dialogue and interactions that make the game more colorful and realistic. The NPC is carrying a red key and a quest.

>take quest
That's abstract!

* * *

>talk npc
I didn't understand that sentence.

>talk to npc
You looks at you with a blank expression and says, "I once saw a purple elephant!, Did you know that clouds are actually made of cotton candy?, I think my left shoe is trying to communicate with me., Sometimes I dream I'm a talking banana. and I'm convinced that squirrels are secretly running the world."

* * *

>track responses
Now tracking responses. Type "track off" to disable.

>rules
Rules tracing now switched on. Type "rules off" to switch it off again, or "rules all" to include even rules which do not apply.

[Rule "parse command rule" applies.]

[I beg your pardon? - type "response 1" for details]

* * *

>x npc
You see nothing special about the NPC. The NPC is a non-player character. "Non-player character" is a professional term of art used amongst professional game designers, so I don't expect you to understand what it means. It's a very technical term, meaning that you don't control that character, as opposed to the player character, which you do control. I don't want to get into it all right now. Just assume that the NPC is a person, with lots of interesting dialogue and interactions that make the game more colorful and realistic. The NPC is carrying a red key and a quest.

>take quest
Technically, you're not supposed to be able to do that, because there's a default rule that prevents you from taking other people's possessions. I intended to make a puzzle here, where you had to say some sort of password like "xyzzy" to the NPC, but I never got around to implementing it, so there's this bug you can exploit, where you can just whatever the NPC is holding without asking permission first. I will get around to patching this bug in the next release of this game.

That's abstract!

* * *

>z
Time passes.

The NPC suddenly exclaims, "I forgot what I was going to say."

>z
Time passes.

>z
Time passes.

The NPC suddenly exclaims, "I forgot what I was going to say."

* * *

>z
Time passes.

What?

>z
Time passes.

Hello?

>z
Time passes.

>talk to npc
You looks at you with a blank expression and says, "I once saw a purple elephant!, Did you know that clouds are actually made of cotton candy?, I think my left shoe is trying to communicate with me., Sometimes I dream I'm a talking banana. and I'm convinced that squirrels are secretly running the world."

* * *

>g
You looks at you with a blank expression and says, "What were we talking about again?
"

>g
You looks at you with a blank expression and says, "I once saw a purple elephant!, Did you know that clouds are actually made of cotton candy?, I think my left shoe is trying to communicate with me., Sometimes I dream I'm a talking banana. and I'm convinced that squirrels are secretly running the world."
The NPC suddenly exclaims, "I forgot what I was going to say."

>g
You looks at you with a blank expression and says, "What were we talking about again?
"
The NPC suddenly exclaims, "I forgot what I was going to say."

>g
You looks at you with a blank expression and says, "I once saw a purple elephant!, Did you know that clouds are actually made of cotton candy?, I think my left shoe is trying to communicate with me., Sometimes I dream I'm a talking banana. and I'm convinced that squirrels are secretly running the world."

Huh?

>g
You looks at you with a blank expression and says, "What were we talking about again?
"

* * *

>g
You looks at you with a blank expression and says, "I once saw a purple elephant!, Did you know that clouds are actually made of cotton candy?, I think my left shoe is trying to communicate with me., Sometimes I dream I'm a talking banana. and I'm convinced that squirrels are secretly running the world."
The NPC suddenly exclaims, "I forgot what I was going to say."

>g
You looks at you with a blank expression and says, "What were we talking about again?
"

I beg your pardon?

>g
You looks at you with a blank expression and says, "I once saw a purple elephant!, Did you know that clouds are actually made of cotton candy?, I think my left shoe is trying to communicate with me., Sometimes I dream I'm a talking banana. and I'm convinced that squirrels are secretly running the world."

>g
You looks at you with a blank expression and says, "What were we talking about again?
"
The NPC suddenly exclaims, "I forgot what I was going to say."

* * *

>g
You looks at you with a blank expression and says, "What were we talking about again?
"

>attack
What do you want to attack?

>me
You attack yourself.

>npc, attack me
Violence is apparently the answer to this one.